AA	Ambulansearbeider	
AT	Apotektekniker	
AU	Audiograf	
BI	Bioingeniør	
ET	Ergoterapeut	
FA1	Provisorfarmasøyt	
FA2	Reseptarfarmasøyt	
FB	Fiskehelsebiolog	
FO	Fotterapeut	
FT	Fysioterapeut	
HE	Helsesekretær	
HF	Helsefagarbeider	
HP	Hjelpepleier	
HS	Helsesykepleier	
JO	Jordmor	
KE	Klinisk ernæringsfysiolog	
KI	Kiropraktor	
LE	Lege	
OA	Omsorgsarbeider	
OI	Ortopediingeniør	
OP	Optiker	
OR	Ortoptist	
PE	Perfusjonist	
PS	Psykolog	
RA	Radiograf	
SP	Sykepleier	
TH	Tannhelsesekretær	
TL	Tannlege	
TP	Tannpleier	
TT	Tanntekniker	
VE	Veterinær	
VP	Vernepleier	
XX	Ukjent/uspesifisert